murs:
   {x: 80,y: 210 }, 
   {x: 80,y: 220 }, 
   {x: 80,y: 230 }, 
   {x: 80,y: 240 }, 
   {x: 80,y: 250 }, 
   {x: 80,y: 260 }, 
   {x: 80,y: 270 }, 
   {x: 80,y: 280 }, 
   {x: 80,y: 290 }, 
   {x: 80,y: 300 }, 
   {x: 80,y: 310 }, 
   {x: 80,y: 320 }, 
   {x: 80,y: 330 }, 
   {x: 90,y: 330 }, 
   {x: 100,y: 330 }, 
   {x: 110,y: 330 }, 
   {x: 120,y: 330 }, 
   {x: 130,y: 330 }, 
   {x: 140,y: 330 }, 
   {x: 150,y: 330 }, 
   {x: 160,y: 330 }, 
   {x: 160,y: 320 }, 
   {x: 160,y: 310 }, 
   {x: 160,y: 300 }, 
   {x: 160,y: 290 }, 
   {x: 160,y: 280 }, 
   {x: 160,y: 270 }, 
   {x: 160,y: 260 }, 
   {x: 160,y: 250 }, 
   {x: 160,y: 240 }, 
   {x: 160,y: 230 }, 
   {x: 160,y: 220 }, 
   {x: 160,y: 210 }, 
   {x: 150,y: 210 }, 
   {x: 140,y: 210 }, 
   {x: 130,y: 210 }, 
   {x: 120,y: 210 }, 
   {x: 110,y: 210 }, 
   {x: 100,y: 210 }, 
   {x: 90,y: 210 }, 
   {x: 710,y: 210 }, 
   {x: 700,y: 210 }, 
   {x: 690,y: 210 }, 
   {x: 680,y: 210 }, 
   {x: 670,y: 210 }, 
   {x: 660,y: 210 }, 
   {x: 650,y: 210 }, 
   {x: 640,y: 210 }, 
   {x: 630,y: 210 }, 
   {x: 630,y: 220 }, 
   {x: 630,y: 230 }, 
   {x: 630,y: 240 }, 
   {x: 630,y: 250 }, 
   {x: 630,y: 260 }, 
   {x: 630,y: 270 }, 
   {x: 630,y: 280 }, 
   {x: 630,y: 290 }, 
   {x: 630,y: 300 }, 
   {x: 630,y: 310 }, 
   {x: 630,y: 320 }, 
   {x: 630,y: 330 }, 
   {x: 640,y: 330 }, 
   {x: 650,y: 330 }, 
   {x: 660,y: 330 }, 
   {x: 670,y: 330 }, 
   {x: 680,y: 330 }, 
   {x: 690,y: 330 }, 
   {x: 700,y: 330 }, 
   {x: 710,y: 330 }, 
   {x: 710,y: 320 }, 
   {x: 710,y: 310 }, 
   {x: 710,y: 300 }, 
   {x: 710,y: 290 }, 
   {x: 710,y: 280 }, 
   {x: 710,y: 270 }, 
   {x: 710,y: 260 }, 
   {x: 710,y: 240 }, 
   {x: 710,y: 230 }, 
   {x: 710,y: 220 }, 
   {x: 710,y: 250 }, 
   {x: 200,y: 330 }, 
   {x: 210,y: 330 }, 
   {x: 220,y: 330 }, 
   {x: 230,y: 330 }, 
   {x: 240,y: 330 }, 
   {x: 250,y: 330 }, 
   {x: 260,y: 330 }, 
   {x: 270,y: 330 }, 
   {x: 280,y: 330 }, 
   {x: 290,y: 330 }, 
   {x: 300,y: 330 }, 
   {x: 310,y: 330 }, 
   {x: 320,y: 330 }, 
   {x: 330,y: 330 }, 
   {x: 340,y: 330 }, 
   {x: 350,y: 330 }, 
   {x: 360,y: 330 }, 
   {x: 370,y: 330 }, 
   {x: 380,y: 330 }, 
   {x: 390,y: 330 }, 
   {x: 400,y: 330 }, 
   {x: 410,y: 330 }, 
   {x: 420,y: 330 }, 
   {x: 430,y: 330 }, 
   {x: 440,y: 330 }, 
   {x: 450,y: 330 }, 
   {x: 460,y: 330 }, 
   {x: 470,y: 330 }, 
   {x: 480,y: 330 }, 
   {x: 490,y: 330 }, 
   {x: 500,y: 330 }, 
   {x: 510,y: 330 }, 
   {x: 520,y: 330 }, 
   {x: 530,y: 330 }, 
   {x: 540,y: 330 }, 
   {x: 550,y: 330 }, 
   {x: 560,y: 330 }, 
   {x: 570,y: 330 }, 
   {x: 580,y: 330 }, 
   {x: 590,y: 330 }, 
   {x: 590,y: 320 }, 
   {x: 590,y: 310 }, 
   {x: 590,y: 300 }, 
   {x: 590,y: 290 }, 
   {x: 590,y: 280 }, 
   {x: 590,y: 270 }, 
   {x: 590,y: 260 }, 
   {x: 590,y: 250 }, 
   {x: 590,y: 240 }, 
   {x: 590,y: 230 }, 
   {x: 590,y: 220 }, 
   {x: 590,y: 210 }, 
   {x: 580,y: 210 }, 
   {x: 570,y: 210 }, 
   {x: 560,y: 210 }, 
   {x: 550,y: 210 }, 
   {x: 540,y: 210 }, 
   {x: 530,y: 210 }, 
   {x: 520,y: 210 }, 
   {x: 510,y: 210 }, 
   {x: 490,y: 210 }, 
   {x: 480,y: 210 }, 
   {x: 470,y: 210 }, 
   {x: 460,y: 210 }, 
   {x: 450,y: 210 }, 
   {x: 440,y: 210 }, 
   {x: 430,y: 210 }, 
   {x: 420,y: 210 }, 
   {x: 410,y: 210 }, 
   {x: 400,y: 210 }, 
   {x: 390,y: 210 }, 
   {x: 380,y: 210 }, 
   {x: 370,y: 210 }, 
   {x: 360,y: 210 }, 
   {x: 350,y: 210 }, 
   {x: 340,y: 210 }, 
   {x: 330,y: 210 }, 
   {x: 320,y: 210 }, 
   {x: 310,y: 210 }, 
   {x: 310,y: 210 }, 
   {x: 290,y: 210 }, 
   {x: 280,y: 210 }, 
   {x: 270,y: 210 }, 
   {x: 260,y: 210 }, 
   {x: 250,y: 210 }, 
   {x: 240,y: 210 }, 
   {x: 230,y: 210 }, 
   {x: 220,y: 210 }, 
   {x: 210,y: 210 }, 
   {x: 200,y: 210 }, 
   {x: 200,y: 220 }, 
   {x: 200,y: 230 }, 
   {x: 200,y: 240 }, 
   {x: 200,y: 250 }, 
   {x: 200,y: 260 }, 
   {x: 200,y: 270 }, 
   {x: 200,y: 280 }, 
   {x: 200,y: 290 }, 
   {x: 200,y: 300 }, 
   {x: 200,y: 310 }, 
   {x: 200,y: 320 }, 
   {x: 300,y: 210 }, 
   {x: 500,y: 210 }, 
cube level design.html:242:17
teleporteurs:
{x: 120,y: 230 }, 
{x: 230,y: 270 }, 
{x: 560,y: 270 }, 
{x: 670,y: 300 }, 
cube level design.html:243:17
start:
 {x: 120,y: 300 } cube level design.html:244:17
zone finale:
 {x: 670,y: 240 } cube level design.html:245:17

​

